+++++++++++++++++++++
+S+   +     + +   + +
+ +++ + +++ + + + + +
+   +   + +   +   + +
+ + + +++ +++++ +++ +
+ +   + +   + +   + +
+ +++++ + + + + +++ +
+     +   +   +     +
+++++ +++++ + +++++ +
+   +       +       +
+++++++++++++++++++++